Cellar
An Interactive Fiction by Phil Gleghorn
Release 1 / Serial number 220423 / Inform 7 build 6M62 (I6/v6.34 lib 6/12N) SD

Hallway
You are in the hallway of the abandoned house.  Once it may have been a cherished home but now it is a ruin.  The torn and faded wallpaper is covered in graffiti.  The evening sun filters through broken windows, illuminating dust motes hanging in the air.  A crumbling staircase leads up to the first floor.  A pile of junk mail is scattered on the ground.

A heavy wooden door in front of you leads to the cellar, it is closed.

>climb
(the torch)
Little is to be achieved by that.

>climb staircase
Landing
A crumbling staircase leads up to the first floor

* * *

Cellar
An Interactive Fiction by Phil Gleghorn
Release 1 / Serial number 220423 / Inform 7 build 6M62 (I6/v6.34 lib 6/12N) SD

Hallway
You are in the hallway of the abandoned house.  Once it may have been a cherished home but now it is a ruin.  The torn and faded wallpaper is covered in graffiti.  The evening sun filters through broken windows, illuminating dust motes hanging in the air.  A crumbling staircase leads up to the first floor.  A pile of junk mail is scattered on the ground.

A heavy wooden door in front of you leads to the cellar, it is closed.

>climb staircae
You can't see any such thing.

>climb staircase
This staircase is falling apart and will surely collapse if you put any weight on it

>go up
This staircase is falling apart and will surely collapse if you put any weight on it

>up
This staircase is falling apart and will surely collapse if you put any weight on it

>enter staircase
Landing
A crumbling staircase leads up to the first floor

* * *

Cellar
An Interactive Fiction by Phil Gleghorn
Release 1 / Serial number 220423 / Inform 7 build 6M62 (I6/v6.34 lib 6/12N) SD

Hallway
You are in the hallway of the abandoned house.  Once it may have been a cherished home but now it is a ruin.  The torn and faded wallpaper is covered in graffiti.  The evening sun filters through broken windows, illuminating dust motes hanging in the air.  A crumbling staircase leads up to the first floor.  A pile of junk mail is scattered on the ground.

A heavy wooden door in front of you leads to the cellar, it is closed.

>d
Cellar Staircase
You are standing at the top of a wooden staircase, which descends into the gloomy cellar.  The air is musty and damp.  You can hear a low humming sound coming from below.

>u
Hallway
You are in the hallway of the abandoned house.  Once it may have been a cherished home, but now it is a ruin. The wallpaper, torn and faded, is covered in graffiti.  The evening sun filters through broken windows, illuminating dust motes hanging in the air.  A crumbling staircase leads up to the first floor.   In front of you stands a cellar door with a tarnished brass latch. 

You can see a cellar door and a pile of junk mail here.

>u
You can't go that way.

>up
You can't go that way.

>go up
You can't go that way.

>look
Hallway
You are in the hallway of the abandoned house.  Once it may have been a cherished home, but now it is a ruin. The wallpaper, torn and faded, is covered in graffiti.  The evening sun filters through broken windows, illuminating dust motes hanging in the air.  A crumbling staircase leads up to the first floor.   In front of you stands a cellar door with a tarnished brass latch. 

You can see a cellar door and a pile of junk mail here.

>exam door
That's not a verb I recognise.

>examine door
A heavy wooden door, covered in flaking paint. From behind the door you can hear a faint humming sound.

* * *

Cellar
An Interactive Fiction by Phil Gleghorn
Release 1 / Serial number 220423 / Inform 7 build 6M62 (I6/v6.34 lib 6/12N) SD

Hallway
You are in the hallway of the abandoned house.  Once it may have been a cherished home but now it is a ruin.  The torn and faded wallpaper is covered in graffiti.  The evening sun filters through broken windows, illuminating dust motes hanging in the air.  A crumbling staircase leads up to the first floor.  A pile of junk mail is scattered on the ground.

A heavy wooden door in front of you leads to the cellar, it is closed.

>down
Cellar Staircase
You are standing at the top of a wooden staircase, which descends into the gloomy cellar.  The air is musty and damp.  You can hear a low humming sound coming from below.

>n
You can't go that way.

>u
This staircase is falling apart and will surely collapse if you put any weight on it

* * *

Cellar
An Interactive Fiction by Phil Gleghorn
Release 1 / Serial number 220423 / Inform 7 build 6M62 (I6/v6.34 lib 6/12N) SD

Hallway
You are in the hallway of the abandoned house.  Once it may have been a cherished home but now it is a ruin.  The torn and faded wallpaper is covered in graffiti.  The evening sun filters through broken windows, illuminating dust motes hanging in the air.  A crumbling staircase leads up to the first floor.  A pile of junk mail is scattered on the ground.

A heavy wooden door in front of you leads to the cellar, it is closed.

>enter
You must supply a noun.

>enter door
(first opening the cellar door)

Dark Passage
You are standing at the top of a dark passage, which descends into the gloomy cellar.  The air is musty and damp.  You can hear a low humming sound coming from below. 

A heavy wooden door leads to back to the hallway, it is open.

>donw
That's not a verb I recognise.

>down
Cellar
You are in the cellar.

* * *

Cellar
An Interactive Fiction by Phil Gleghorn
Release 1 / Serial number 220423 / Inform 7 build 6M62 (I6/v6.34 lib 6/12N) SD

Hallway
You are in the hallway of the abandoned house.  Once it may have been a cherished home but now it is a ruin.  The torn and faded wallpaper is covered in graffiti.  The evening sun filters through broken windows, illuminating dust motes hanging in the air.  A crumbling staircase leads up to the first floor.  A pile of junk mail is scattered on the ground.

A heavy wooden door in front of you leads to the cellar, it is closed.

>enter staircase
This staircase is falling apart and will surely collapse if you put any weight on it

>up
This staircase is falling apart and will surely collapse if you put any weight on it

>showme
Hallway - room
    yourself - person
        torch
    crumbling staircase - staircase
    cellar door - closed door
    pile of junk mail

>up
This staircase is falling apart and will surely collapse if you put any weight on it

>x staircase
It is falling apart and will surely collapse if you put any weight on it

>in
Cellar Staircase
You are standing at the top of a wooden staircase, which descends into the gloomy cellar.  The air is musty and damp.  You can hear a low humming sound coming from below.

* * *

Cellar
An Interactive Fiction by Phil Gleghorn
Release 1 / Serial number 220423 / Inform 7 build 6M62 (I6/v6.34 lib 6/12N) SD

Hallway
You are in the hallway of the abandoned house.  Once it may have been a cherished home but now it is a ruin.  The torn and faded wallpaper is covered in graffiti.  The evening sun filters through broken windows, illuminating dust motes hanging in the air.  A crumbling staircase leads up to the first floor.  A pile of junk mail is scattered on the ground.

A heavy wooden door in front of you leads to the cellar, it is closed.

>exam staircase
That's not a verb I recognise.

>x staircase
You see nothing special about the staircase.

* * *

Cellar
An Interactive Fiction by Phil Gleghorn
Release 1 / Serial number 220423 / Inform 7 build 6M62 (I6/v6.34 lib 6/12N) SD

Hallway
You are in the hallway of the abandoned house.  Once it may have been a cherished home but now it is a ruin.  The torn and faded wallpaper is covered in graffiti.  The evening sun filters through broken windows, illuminating dust motes hanging in the air.  A crumbling staircase leads up to the first floor.  A pile of junk mail is scattered on the ground.

A heavy wooden door in front of you leads to the cellar, it is closed.

>examine door
A heavy wooden door, covered in flaking paint. From behind the door you can hear a faint humming sound.

>listen at door
I only understood you as far as wanting to listen.

>listen door
I only understood you as far as wanting to listen.

>n
(first opening the cellar door)
You can't, since the cellar door leads nowhere.

>open door
That's already open.

>down
You can't go that way.

>in
Cellar Staircase
You are standing at the top of a wooden staircase, which descends into the gloomy cellar.  The air is musty and damp.  You can hear a low humming sound coming from below.

* * *

Cellar
An Interactive Fiction by Phil Gleghorn
Release 1 / Serial number 220423 / Inform 7 build 6M62 (I6/v6.34 lib 6/12N) SD

Hallway
You are in the hallway of the abandoned house.  Once it may have been a cherished home but now it is a ruin.  The torn and faded wallpaper is covered in graffiti.  The evening sun filters through broken windows, illuminating dust motes hanging in the air.  A crumbling staircase leads up to the first floor.  A pile of junk mail is scattered on the ground.

A heavy wooden door in front of you leads to the cellar, it is closed.

>examine torch
You see nothing special about the torch.

>turn torch on
It isn't something you can switch.

* * *

Cellar
An Interactive Fiction by Phil Gleghorn
Release 1 / Serial number 220423 / Inform 7 build 6M62 (I6/v6.34 lib 6/12N) SD

Hallway
You are in the hallway of the abandoned house.  Once it may have been a cherished home but now it is a ruin.  The torn and faded wallpaper is covered in graffiti.  The evening sun filters through broken windows, illuminating dust motes hanging in the air.  A crumbling staircase leads up to the first floor.  A pile of junk mail is scattered on the ground.

A heavy wooden door in front of you leads to the cellar, it is closed.

>get blah
You can't see any such thing.

>examine blah
You can't see any such thing.

>examine junk
You see nothing special about the pile of junk mail.

>x staircase
You can't see any such thing.

* * *

Cellar
An Interactive Fiction by Phil Gleghorn
Release 1 / Serial number 220423 / Inform 7 build 6M62 (I6/v6.34 lib 6/12N) SD

Hallway
You are in the hallway of the abandoned house.  Once it may have been a cherished home but now it is a ruin.  The torn and faded wallpaper is covered in graffiti.  The evening sun filters through broken windows, illuminating dust motes hanging in the air.  A crumbling staircase leads up to the first floor.  A pile of junk mail is scattered on the ground.

A heavy wooden door in front of you leads to the cellar, it is closed.

>get farts
What's that? Speak up, speak up.

* * *

Cellar
An Interactive Fiction by Phil Gleghorn
Release 1 / Serial number 220423 / Inform 7 build 6M62 (I6/v6.34 lib 6/12N) SD

Hallway
You are in the hallway of the abandoned house.  Once it may have been a cherished home but now it is a ruin.  The torn and faded wallpaper is covered in graffiti.  The evening sun filters through broken windows, illuminating dust motes hanging in the air.  A crumbling staircase leads up to the first floor.  A pile of junk mail is scattered on the ground.

A heavy wooden door in front of you leads to the cellar, it is closed.

>get junk
You browse through the junk mail but find nothing interesting, so decide to leave it.

>exam junk
That's not a verb I recognise.

>examine junk
You see nothing special about the pile of junk mail.

* * *

>get junk
You browse through the junk mail but find nothing interesting, so decide to leave it.

>go up
The staircase looks like it will collapse if you put any weight on it

* * *

>get junk
You browse through the junk mail but find nothing interesting, so decide to leave it.

>open door
You open the cellar door.

>n
Dark Passage
You are standing at the top of a dark passage, which descends into the gloomy cellar.  The air is musty and damp.  You can hear a low humming sound coming from below. 

A heavy wooden door behind you leads back to the hallway, it is open.

>s
Hallway
You are in the hallway of the abandoned house.  Once it may have been a cherished home but now it is a ruin. The torn and faded wallpaper is covered in graffiti.  The evening sun filters through broken windows, illuminating dust motes hanging in the air.  A pile of junk mail covers the floor.

A heavy wooden door in front of you leads to the cellar, it is open.

A crumbling staircase leads up to the first floor

>n
Dark Passage
You are standing at the top of a dark passage, which descends into the gloomy cellar.  The air is musty and damp.  You can hear a low humming sound coming from below. 

A heavy wooden door behind you leads back to the hallway, it is open.

>n
Darkness
It is pitch dark, and you can't see a thing.

>inv
You are carrying:
  a torch

>inv
You are carrying:
  a torch

>use torch
That's not a verb I recognise.

>turn torch on
You switch the torch on.

>n
You can't go that way.

* * *

>get junk
You browse through the junk mail but find nothing interesting, so decide to leave it.

>x door
You see nothing special about the cellar door.

* * *

Cellar
An Interactive Fiction by Phil Gleghorn
Release 1 / Serial number 220423 / Inform 7 build 6M62 (I6/v6.34 lib 6/12N) SD

Hallway
You are in the hallway of the abandoned house.  Once it may have been a cherished home but now it is a ruin.  The torn and faded wallpaper is covered in graffiti.  The evening sun filters through broken windows, illuminating dust motes hanging in the air.  A crumbling staircase leads up to the first floor.  A pile of junk mail is scattered on the ground.

A heavy wooden door in front of you leads to the cellar, it is closed.

>get junk mail
You browse through the junk mail but find nothing interesting, so decide to leave it.

>examine junk mail
You see nothing special about the pile of junk mail.

>up
The staircase looks like it will collapse if you put any weight on it

* * *

>get junk mail
You browse through the junk mail but find nothing interesting, so decide to leave it.

>x junk
An assortment of advertisments and unpaid bills from years ago

>x door
It is covered in flaking paint, with heavy hinges and a tarnished brass latch. From behind the door you can hear a faint humming sound

>open door
You open the cellar door.

>x door
It is covered in flaking paint, with heavy hinges and a tarnished brass latch. You can see a gloomy passage beyond, and hear a strange humming noise from within

>look
Hallway
You are in the hallway of the abandoned house.  Once it may have been a cherished home but now it is a ruin. The torn and faded wallpaper is covered in graffiti.  The evening sun filters through broken windows, illuminating dust motes hanging in the air.

A crumbling staircase leads up to the first floor

A heavy wooden door leads to to the cellar

You can also see a pile of junk mail here.

* * *

Cellar
An Interactive Fiction by Phil Gleghorn
Release 1 / Serial number 220423 / Inform 7 build 6M62 (I6/v6.34 lib 6/12N) SD

Hallway
You are in the hallway of the abandoned house.  Once it may have been a cherished home but now it is a ruin.  The torn and faded wallpaper is covered in graffiti.  The evening sun filters through broken windows, illuminating dust motes hanging in the air.  A crumbling staircase leads up to the first floor.  A pile of junk mail is scattered on the ground.

A heavy wooden door in front of you leads to the cellar, it is closed.

>get pile
You don't see anything of interest

>get junk
You don't see anything of interest

>get junk ail
I only understood you as far as wanting to get the pile of junk mail.

>get junk mail
You don't see anything of interest

>get pile
You don't see anything of interest

* * *

Cellar
An Interactive Fiction by Phil Gleghorn
Release 1 / Serial number 220423 / Inform 7 build 6M62 (I6/v6.34 lib 6/12N) SD

Hallway
You are in the hallway of the abandoned house.  Once it may have been a cherished home but now it is a ruin.  The torn and faded wallpaper is covered in graffiti.  The evening sun filters through broken windows, illuminating dust motes hanging in the air.  A crumbling staircase leads up to the first floor.  A pile of junk mail is scattered on the ground.

A heavy wooden door in front of you leads to the cellar, it is closed.

>get windows
You don't want to cut yourself.

>actions
Actions listing on.

>scenes
Scene 'Entire Game' playing (for 1 mins now)
(Scene monitoring now switched on. Type "scenes off" to switch it off again.)

>examine doo
You can't see any such thing.

>examine door
[examining the cellar door]
It is covered in flaking paint, with heavy hinges and a tarnished brass latch. From behind the door you can hear a faint humming sound

[examining the cellar door - succeeded]

>s
[going south]
You can't go that way.
[going south - failed the can't go that way rule]

* * *

Cellar
An Interactive Fiction by Phil Gleghorn
Release 1 / Serial number 220423 / Inform 7 build 6M62 (I6/v6.34 lib 6/12N) SD

Hallway
You are in the hallway of the abandoned house.  Once it may have been a cherished home but now it is a ruin.  The torn and faded wallpaper is covered in graffiti.  The evening sun filters through broken windows, illuminating dust motes hanging in the air.  A crumbling staircase leads up to the first floor.  A pile of junk mail is scattered on the ground.

A heavy wooden door in front of you leads to the cellar, it is closed.

>go up stairs
I only understood you as far as wanting to go up.

>go up staircase
I only understood you as far as wanting to go up.

>open door
You open the cellar door.

* * *

>n
Dark Passage
You are standing at the top of a dark passage, which descends into the gloomy cellar.  The air is musty and damp.  You can hear a low humming sound coming from below. 

A heavy wooden door behind you leads back to the hallway, it is open.

>e
You can't go that way.

>w
You can't go that way.

>turn on torch
You switch the torch on.

>n
Darkness
It is pitch dark, and you can't see a thing.

>s
Dark Passage
You are standing at the top of a dark passage, which descends into the gloomy cellar.  The air is musty and damp.  You can hear a low humming sound coming from below. 

A heavy wooden door behind you leads back to the hallway, it is open.

>s
Hallway
You are in the hallway of the abandoned house.  Once it may have been a cherished home but now it is a ruin. The torn and faded wallpaper is covered in graffiti.  The evening sun filters through broken windows, illuminating dust motes hanging in the air.  A crumbling staircase leads up to the first floor.  A pile of junk mail is scattered on the ground.

A heavy wooden door in front of you leads to the cellar, it is open.

>close door
You close the cellar door.

>s
You can't go that way.

>w
You can't go that way.

>e
You can't go that way.

>n
(first opening the cellar door)

Dark Passage
You are standing at the top of a dark passage, which descends into the gloomy cellar.  The air is musty and damp.  You can hear a low humming sound coming from below. 

A heavy wooden door behind you leads back to the hallway, it is open.

>s
Hallway
You are in the hallway of the abandoned house.  Once it may have been a cherished home but now it is a ruin. The torn and faded wallpaper is covered in graffiti.  The evening sun filters through broken windows, illuminating dust motes hanging in the air.  A crumbling staircase leads up to the first floor.  A pile of junk mail is scattered on the ground.

A heavy wooden door in front of you leads to the cellar, it is open.

>up
It doesn't look safe to use the staircase

>down
You can't go that way.

* * *

Cellar
An Interactive Fiction by Phil Gleghorn
Release 1 / Serial number 220423 / Inform 7 build 6M62 (I6/v6.34 lib 6/12N) SD

Hallway
You are in the hallway of the abandoned house.  Once it may have been a cherished home but now it is a ruin.  The torn and faded wallpaper is covered in graffiti.  The evening sun filters through broken windows, illuminating dust motes hanging in the air.  A crumbling staircase leads up to the first floor.  A pile of junk mail is scattered on the ground.

A heavy wooden door in front of you leads to the cellar, it is closed.

>help
That's not a verb I recognise.

>look
Example Location

>inv
You are carrying nothing.

>w
You can't go that way.

>exit
But you aren't in anything at the moment.

>quit
Are you sure you want to quit?

* * *

Cellar
An Interactive Fiction by Phil Gleghorn
Release 1 / Serial number 220423 / Inform 7 build 6M62 (I6/v6.34 lib 6/12N) SD

Hallway
You are in the hallway of the abandoned house.  Once it may have been a cherished home but now it is a ruin.  The torn and faded wallpaper is covered in graffiti.  The evening sun filters through broken windows, illuminating dust motes hanging in the air.  A crumbling staircase leads up to the first floor.  A pile of junk mail is scattered on the ground.

A heavy wooden door in front of you leads to the cellar, it is closed.

>in
You can't go that way.

I beg your pardon?

>n
(first opening the cellar door)

Dark Passage
You are standing at the top of a dark passage, which descends into the gloomy cellar.  The air is musty and damp.  You can hear a low humming sound coming from below. 

A heavy wooden door leads to back to the hallway, it is open.

>d
Darkness
It is pitch dark, and you can't see a thing.

* * *

>in
You can't go that way.

>enter
You must supply a noun.

* * *

Cellar
An Interactive Fiction by Phil Gleghorn
Release 1 / Serial number 220423 / Inform 7 build 6M62 (I6/v6.34 lib 6/12N) SD

Hallway
You are in the hallway of the abandoned house.  Once it may have been a cherished home but now it is a ruin.  The torn and faded wallpaper is covered in graffiti.  The evening sun filters through broken windows, illuminating dust motes hanging in the air.  A crumbling staircase leads up to the first floor.  A pile of junk mail is scattered on the ground.

A heavy wooden door in front of you leads to the cellar, it is closed.

>inv
You are carrying:
  a torch

>examine torch
You see nothing special about the torch.

* * *

>inv
You are carrying:
  a torch

>get junk
No thanks

>n
You can't go that way.

>go to stairs
You can't see any such thing.

>go up
The staircase looks like it will collapse if you put any weight on it

>open cellar
It isn't something you can open.

* * *

>inv
You are carrying:
  a torch

>n
(first opening the cellar door)

Dark Passage
You are standing at the top of a dark passage, which descends into the gloomy cellar.  The air is musty and damp.  You can hear a low humming sound coming from below. 

A heavy wooden door behind you leads back to the hallway, it is open.

* * *

>s
Hallway
You are in the hallway of the abandoned house.  Once it may have been a cherished home but now it is a ruin. The torn and faded wallpaper is covered in graffiti.  The evening sun filters through broken windows, illuminating dust motes hanging in the air.  A crumbling staircase leads up to the first floor.  A pile of junk mail is scattered on the ground.

A heavy wooden door in front of you leads to the cellar, it is open.

>open door
That's already open.

>close door
You close the cellar door.

>kick down door
That's not a verb I recognise.

>open door
You open the cellar door.

* * *

>inv
You are carrying:
  a torch

>x torch
A small battery-operated torch.

The torch is currently switched off.

>get door
Taken.

* * *

>x torch
A small battery-operated torch.

The torch is currently switched off.

>switch on torch
You switch the torch on.

>x torch
A small battery-operated torch.

The torch is currently switched on.

>inv
You are carrying:
  a torch

>look
Hallway
You are in the hallway of the abandoned house.  Once it may have been a cherished home but now it is a ruin. The torn and faded wallpaper is covered in graffiti.  The evening sun filters through broken windows, illuminating dust motes hanging in the air.

A crumbling staircase leads up to the first floor

A heavy wooden door leads to to the cellar

You can also see a pile of junk mail here.

>down
You can't go that way.

* * *

>x torch
A small battery-operated torch.

The torch is currently switched off.

>use torch
That's not a verb I recognise.

>switch on torch
You switch the torch on.

>inv
You are carrying:
  a torch (providing light)

* * *

Cellar
An Interactive Fiction by Phil Gleghorn
Release 1 / Serial number 220423 / Inform 7 build 6M62 (I6/v6.34 lib 6/12N) SD

Hallway
You are in the hallway of the abandoned house.  Once it may have been a cherished home but now it is a ruin.  The torn and faded wallpaper is covered in graffiti.  The evening sun filters through broken windows, illuminating dust motes hanging in the air.  A crumbling staircase leads up to the first floor.  A pile of junk mail is scattered on the ground.

A heavy wooden door in front of you leads to the cellar, it is closed.

>n
(first opening the cellar door)

Dark Passage
You are standing at the top of a dark passage, which descends into the gloomy cellar.  The air is musty and damp.  You can hear a low humming sound coming from below. 

A heavy wooden door behind you leads back to the hallway, it is open.

>close door
You close the cellar door.

It is now pitch dark in here!

I beg your pardon?

>s
(first opening the cellar door)

Hallway
You are in the hallway of the abandoned house.  Once it may have been a cherished home but now it is a ruin.  The torn and faded wallpaper is covered in graffiti.  The evening sun filters through broken windows, illuminating dust motes hanging in the air.  A crumbling staircase leads up to the first floor.  A pile of junk mail is scattered on the ground.

A heavy wooden door in front of you leads to the cellar, it is open.

>n
Dark Passage
You are standing at the top of a dark passage, which descends into the gloomy cellar.  The air is musty and damp.  You can hear a low humming sound coming from below. 

A heavy wooden door behind you leads back to the hallway, it is open.

>close open
You can't see any such thing.

>close door
You close the cellar door.

It is now pitch dark in here!

>open door
You can't see any such thing.

>s
(first opening the cellar door)

Hallway
You are in the hallway of the abandoned house.  Once it may have been a cherished home but now it is a ruin.  The torn and faded wallpaper is covered in graffiti.  The evening sun filters through broken windows, illuminating dust motes hanging in the air.  A crumbling staircase leads up to the first floor.  A pile of junk mail is scattered on the ground.

A heavy wooden door in front of you leads to the cellar, it is open.

* * *

>n
Dark Passage
You are standing at the top of a dark passage, which descends into the gloomy cellar.  The air is musty and damp.  You can hear a low humming sound coming from below. 

A heavy wooden door behind you leads back to the hallway, it is open.

>close door
You close the cellar door.

It is now pitch dark in here!

>turn on torch
You switch the torch on.

Dark Passage
You are standing at the top of a dark passage, which descends into the gloomy cellar.  The air is musty and damp.  You can hear a low humming sound coming from below. 

A heavy wooden door behind you leads back to the hallway, it is closed.

>n
Cellar
You are in the cellar.

>n
You can't go that way.

>w
You can't go that way.

* * *

>e
You can't go that way.

>drop torc
You can't see any such thing.

>drop toch
You can't see any such thing.

>drop torch
Dropped.

>look
Cellar
You are in the cellar.

You can see a torch (providing light) here.

>s
Darkness
It is pitch dark, and you can't see a thing.

>n
Cellar
You are in the cellar.

You can see a torch (providing light) here.

>get torch
Taken.

>throw torch south
I only understood you as far as wanting to throw the torch.

>throw torch to the south
I only understood you as far as wanting to throw the torch.

* * *

>close door
You close the cellar door.

It is now pitch dark in here!

>look
Darkness
It is pitch dark, and you can't see a thing.

>open door
You can't see any such thing.

>open cellar door
You can't see any such thing.

>s
(first opening the cellar door)

Hallway
You are in the hallway of the abandoned house.  Once it may have been a cherished home but now it is a ruin.  The torn and faded wallpaper is covered in graffiti.  The evening sun filters through broken windows, illuminating dust motes hanging in the air.  A crumbling staircase leads up to the first floor.  A pile of junk mail is scattered on the ground.

A heavy wooden door in front of you leads to the cellar, it is open.

* * *

>open door
You can't see any such thing.

>iv
That's not a verb I recognise.

>use torch
That's not a verb I recognise.

* * *

>switch on torch
You switch the torch on.

>look
Darkness
It is pitch dark, and you can't see a thing.

* * *

>n
(first opening the cellar door)

Dark Passage
You are standing at the top of a dark passage, which descends into the gloomy cellar.  The air is musty and damp.  You can hear a low humming sound coming from below. 

A heavy wooden door behind you leads back to the hallway, it is open.

>inv
You are carrying:
  a torch

* * *

>n
(first opening the cellar door)

Dark Passage
You are standing at the top of a dark passage, which descends into the gloomy cellar.  The air is musty and damp.  You can hear a low humming sound coming from below. 

A heavy wooden door behind you leads back to the hallway, it is open.

>l
Hallway
You are in the hallway of the abandoned house.  The evening sun filters through broken windows, illuminating dust motes hanging in the air.  A crumbling staircase leads up to the first floor.   In front of you stands a cellar door with a tarnished brass latch. 

You can see a closed cellar door and a pile of junk mail here.

>open door
That's already open.

* * *

>n
(first opening the cellar door)

Dark Passage
You are standing at the top of a dark passage, which descends into the gloomy cellar.  The air is musty and damp.  You can hear a low humming sound coming from below. 

A heavy wooden door behind you leads back to the hallway, it is open.

>n
Darkness
It is pitch dark, and you can't see a thing.

>light torch
This dangerous act would achieve little.

>switch on torch
You switch the torch on.

* * *

>look
Darkness
It is pitch dark, and you can't see a thing.

>inv
You are carrying:
  a torch

>x torch
It is pitch dark, and you can't see a thing.

>examine torch
It is pitch dark, and you can't see a thing.

>inv
You are carrying:
  a torch

>showme
Cellar - room
    yourself - person
        torch - device

>look
Darkness
It is pitch dark, and you can't see a thing.

>s
Dark Passage
You are standing at the top of a dark passage, which descends into the gloomy cellar.  The air is musty and damp.  You can hear a low humming sound coming from below. 

A heavy wooden door behind you leads back to the hallway, it is open.

* * *

>s
Hallway
You are in the hallway of the abandoned house.  Once it may have been a cherished home but now it is a ruin. The torn and faded wallpaper is covered in graffiti.  The evening sun filters through broken windows, illuminating dust motes hanging in the air.  A crumbling staircase leads up to the first floor.  A pile of junk mail is scattered on the ground.

A heavy wooden door in front of you leads to the cellar, it is open.

>look
Hallway
You are in the hallway of the abandoned house.  Once it may have been a cherished home but now it is a ruin. The torn and faded wallpaper is covered in graffiti.  The evening sun filters through broken windows, illuminating dust motes hanging in the air.  A crumbling staircase leads up to the first floor.  A pile of junk mail is scattered on the ground.

A heavy wooden door in front of you leads to the cellar, it is open.

>n
Dark Passage
You are standing at the top of a dark passage, which descends into the gloomy cellar.  The air is musty and damp.  You can hear a low humming sound coming from below. 

A heavy wooden door behind you leads back to the hallway, it is open.

>close door
You close the cellar door.

>look
Dark Passage
You are standing at the top of a dark passage, which descends into the gloomy cellar.  The air is musty and damp.  You can hear a low humming sound coming from below. 

A heavy wooden door behind you leads back to the hallway, it is closed.

* * *

>n
(first opening the cellar door)

Dark Passage
You are standing at the top of a dark passage, which descends into the gloomy cellar.  The air is musty and damp.  You can hear a low humming sound coming from below. 

A heavy wooden door behind you leads back to the hallway, it is open.

>s
Hallway
You are in the hallway of the abandoned house.  Once it may have been a cherished home but now it is a ruin. The torn and faded wallpaper is covered in graffiti.  The evening sun filters through broken windows, illuminating dust motes hanging in the air.  A pile of junk mail covers the floor.

A heavy wooden door leads to to the cellar, it is open.

A crumbling staircase leads up to the first floor

>exits
That's not a verb I recognise.

>n
Dark Passage
You are standing at the top of a dark passage, which descends into the gloomy cellar.  The air is musty and damp.  You can hear a low humming sound coming from below. 

A heavy wooden door leads to back to the hallway, it is open.

>s
Hallway
You are in the hallway of the abandoned house.  Once it may have been a cherished home but now it is a ruin. The torn and faded wallpaper is covered in graffiti.  The evening sun filters through broken windows, illuminating dust motes hanging in the air.  A pile of junk mail covers the floor.

A heavy wooden door leads to to the cellar, it is open.

A crumbling staircase leads up to the first floor

* * *

Cellar
An Interactive Fiction by Phil Gleghorn
Release 1 / Serial number 220423 / Inform 7 build 6M62 (I6/v6.34 lib 6/12N) SD

Hallway
You are in the hallway of the abandoned house.  Once it may have been a cherished home but now it is a ruin.  The torn and faded wallpaper is covered in graffiti.  The evening sun filters through broken windows, illuminating dust motes hanging in the air.  A crumbling staircase leads up to the first floor.  A pile of junk mail is scattered on the ground.

A heavy wooden door in front of you leads to the cellar, it is closed.

>open door
You open the cellar door.

>look
Hallway
You are in the hallway of the abandoned house.  Once it may have been a cherished home but now it is a ruin. The torn and faded wallpaper is covered in graffiti.  The evening sun filters through broken windows, illuminating dust motes hanging in the air.

A crumbling staircase leads up to the first floor

A heavy wooden door leads to to the cellar, it is open.

You can also see a pile of junk mail here.

>in
Staircase
blah

>out
Hallway
You are in the hallway of the abandoned house.  The evening sun filters through broken windows, illuminating dust motes hanging in the air.  A crumbling staircase leads up to the first floor.   In front of you stands a cellar door with a tarnished brass latch. 

You can see a cellar door and a pile of junk mail here.

>go in
Staircase
blah

>out
Hallway
You are in the hallway of the abandoned house.  The evening sun filters through broken windows, illuminating dust motes hanging in the air.  A crumbling staircase leads up to the first floor.   In front of you stands a cellar door with a tarnished brass latch. 

You can see a cellar door and a pile of junk mail here.

* * *

>n
Dark Passage
You are standing at the top of a dark passage, which descends into the gloomy cellar.  The air is musty and damp.  You can hear a low humming sound coming from below. 

A heavy wooden door behind you leads back to the hallway, it is open.

>turn on torch
You switch the torch on.

* * *

>n
Darkness
It is pitch dark, and you can't see a thing.

>use torch
That's not a verb I recognise.

>n
You can't go that way.

>e
You can't go that way.

* * *

>w
You can't go that way.

>s
Dark Passage
You are standing at the top of a dark passage, which descends into the gloomy cellar.  The air is musty and damp.  You can hear a low humming sound coming from below. 

A heavy wooden door behind you leads back to the hallway, it is open.

>close
(the torch)
It isn't something you can close.

>close door
You close the cellar door.

>turn off torch
You switch the torch off.

>up
You can't go that way.

>s
(first opening the cellar door)

Hallway
You are in the hallway of the abandoned house.  Once it may have been a cherished home but now it is a ruin. The torn and faded wallpaper is covered in graffiti.  The evening sun filters through broken windows, illuminating dust motes hanging in the air.  A crumbling staircase leads up to the first floor.  A pile of junk mail is scattered on the ground.

A heavy wooden door in front of you leads to the cellar, it is open.

>up
It doesn't look safe to use the staircase

>up
It doesn't look safe to use the staircase

>i said go up godammit
I only understood you as far as wanting to take inventory.

>lemme go up or imma bite you
That's not a verb I recognise.

>up
It doesn't look safe to use the staircase

>i dot care about safety just lemme go up
I only understood you as far as wanting to take inventory.

>por favor?
That's not a verb I recognise.

>up
It doesn't look safe to use the staircase

>s
You can't go that way.

>e
You can't go that way.

* * *

>w
You can't go that way.

>n
Dark Passage
You are standing at the top of a dark passage, which descends into the gloomy cellar.  The air is musty and damp.  You can hear a low humming sound coming from below. 

A heavy wooden door behind you leads back to the hallway, it is open.

* * *

>n
Darkness
It is pitch dark, and you can't see a thing.

>n
You can't go that way.

>n
You can't go that way.

>turn on torch
You switch the torch on.

>n
You can't go that way.

>look
Darkness
It is pitch dark, and you can't see a thing.

* * *

>inv
You are carrying:
  a torch

>x torhc
You can't see any such thing.

>x torch
It is pitch dark, and you can't see a thing.

* * *

>examine torch
It is pitch dark, and you can't see a thing.

>turn torch on
That's already on.

* * *

Cellar
An Interactive Fiction by Phil Gleghorn
Release 1 / Serial number 220423 / Inform 7 build 6M62 (I6/v6.34 lib 6/12N) SD

Hallway
You are in the hallway of the abandoned house.  Once it may have been a cherished home but now it is a ruin.  The torn and faded wallpaper is covered in graffiti.  The evening sun filters through broken windows, illuminating dust motes hanging in the air.  A crumbling staircase leads up to the first floor.  A pile of junk mail is scattered on the ground.

A heavy wooden door in front of you leads to the cellar, it is closed.

>open portal
You open the portal.

>open portal
That's already open.

>n
You can't, since the portal leads nowhere.

>e
You can't go that way.

* * *

Cellar
An Interactive Fiction by Phil Gleghorn
Release 1 / Serial number 220423 / Inform 7 build 6M62 (I6/v6.34 lib 6/12N) SD

Hallway
You are in the hallway of the abandoned house.  Once it may have been a cherished home but now it is a ruin.  The torn and faded wallpaper is covered in graffiti.  The evening sun filters through broken windows, illuminating dust motes hanging in the air.  A crumbling staircase leads up to the first floor.  A pile of junk mail is scattered on the ground.

A heavy wooden door in front of you leads to the cellar, it is closed.

>search junk
A postcard catches your eye.

>look
Hallway
You are in the hallway of the abandoned house.  Once it may have been a cherished home but now it is a ruin.  The torn and faded wallpaper is covered in graffiti.  The evening sun filters through broken windows, illuminating dust motes hanging in the air.  A crumbling staircase leads up to the first floor.  A pile of junk mail is scattered on the ground.

A heavy wooden door in front of you leads to the cellar, it is closed.

>inv
You are carrying:
  a postcard
  a torch

* * *

Cellar
An Interactive Fiction by Phil Gleghorn
Release 1 / Serial number 220423 / Inform 7 build 6M62 (I6/v6.34 lib 6/12N) SD

Hallway
You are in the hallway of the abandoned house.  Once it may have been a cherished home but now it is a ruin.  The torn and faded wallpaper is covered in graffiti.  The evening sun filters through broken windows, illuminating dust motes hanging in the air.  A crumbling staircase leads up to the first floor.  A pile of junk mail is scattered on the ground.

A heavy wooden door in front of you leads to the cellar, it is closed.

>showme
Hallway - room
    yourself - person
        torch - device
    crumbling staircase - staircase
    cellar door - closed door
    pile of junk mail
    Broken windows

* * *

Cellar
An Interactive Fiction by Phil Gleghorn
Release 1 / Serial number 220423 / Inform 7 build 6M62 (I6/v6.34 lib 6/12N) SD

Hallway
You are in the hallway of the abandoned house.  Once it may have been a cherished home but now it is a ruin.  The torn and faded wallpaper is covered in graffiti.  The evening sun filters through broken windows, illuminating dust motes hanging in the air.  A crumbling staircase leads up to the first floor.  A pile of junk mail is scattered on the ground.

A heavy wooden door in front of you leads to the cellar, it is closed.

>up
It doesn't look safe to use the staircase

>examine staircase
You see nothing special about the grand staircase.

* * *

>up
It doesn't look safe to use the staircase

>x door
It is covered in flaking paint, with heavy hinges and a tarnished brass latch. From behind the door you can hear a faint humming sound

>n
(first opening the cellar door)
You can't, since the cellar door leads nowhere.

* * *

Cellar
An Interactive Fiction by Phil Gleghorn
Release 1 / Serial number 220423 / Inform 7 build 6M62 (I6/v6.34 lib 6/12N) SD

Hallway
You are in the hallway of the abandoned house.  Once it may have been a cherished home but now it is a ruin.  The torn and faded wallpaper is covered in graffiti.  The evening sun filters through broken windows, illuminating dust motes hanging in the air.  A crumbling staircase leads up to the first floor.  A pile of junk mail is scattered on the ground.

A heavy wooden door in front of you leads to the cellar, it is closed.

>x blah
You can't see any such thing.

>x blah blah
You can't see any such thing.

* * *

Cellar
An Interactive Fiction by Phil Gleghorn
Release 1 / Serial number 220423 / Inform 7 build 6M62 (I6/v6.34 lib 6/12N) SD

Hallway
You are in the hallway of the abandoned house.  Once it may have been a cherished home but now it is a ruin.  The torn and faded wallpaper is covered in graffiti.  The evening sun filters through broken windows, illuminating dust motes hanging in the air.  A crumbling staircase leads up to the first floor.  A pile of junk mail is scattered on the ground.

A heavy wooden door in front of you leads to the cellar, it is closed.

>x broken windows
You see nothing special about the broken windows.

* * *

Cellar
An Interactive Fiction by Phil Gleghorn
Release 1 / Serial number 220423 / Inform 7 build 6M62 (I6/v6.34 lib 6/12N) SD

Hallway
You are in the hallway of the abandoned house.  Once it may have been a cherished home but now it is a ruin.  The torn and faded wallpaper is covered in graffiti.  The evening sun filters through broken windows, illuminating dust motes hanging in the air.  A crumbling staircase leads up to the first floor.  A pile of junk mail is scattered on the ground.

A heavy wooden door in front of you leads to the cellar, it is closed.

>x door
It is covered in flaking paint, with heavy hinges and a tarnished brass latch. From behind the door you can hear a faint humming sound

>close door
That's already closed.

>open door
You open the cellar door.

>x door
It is covered in flaking paint, with heavy hinges and a tarnished brass latch. From behind the door you can hear a faint humming sound

* * *

>open door
You open the cellar door.

>n
Dark Passage
You are standing at the top of a dark passage, which descends into the gloomy cellar.  The air is musty and damp.  You can hear a low humming sound coming from below. 

In front of you stands a heavy wooden door

* * *

>open door
You open the cellar door.

>x door
It is covered in flaking paint, with heavy hinges and a tarnished brass latch. You can see a gloomy passage beyond, you can clearly hear a strange humming noise

* * *

Cellar
An Interactive Fiction by Phil Gleghorn
Release 1 / Serial number 220423 / Inform 7 build 6M62 (I6/v6.34 lib 6/12N) SD

Hallway
You are in the hallway of the abandoned house.  Once it may have been a cherished home but now it is a ruin.  The torn and faded wallpaper is covered in graffiti.  The evening sun filters through broken windows, illuminating dust motes hanging in the air.  A crumbling staircase leads up to the first floor.  A pile of junk mail is scattered on the ground.

A heavy wooden door in front of you leads to the cellar, it is closed.

>x graffiti
You can't see any such thing.

>x graffitti
You can't see any such thing.

* * *

Cellar
An Interactive Fiction by Phil Gleghorn
Release 1 / Serial number 220423 / Inform 7 build 6M62 (I6/v6.34 lib 6/12N) SD

Hallway
You are in the hallway of the abandoned house.  Once it may have been a cherished home but now it is a ruin.  The torn and faded wallpaper is covered in graffiti.  The evening sun filters through broken windows, illuminating dust motes hanging in the air.  A crumbling staircase leads up to the first floor.  A pile of junk mail is scattered on the ground.

A heavy wooden door in front of you leads to the cellar, it is closed.

>x junk
As you sift through the junk mail, a postcard catches your eye.

>get junk
You browse through the junk mail but find nothing interesting, so decide to leave it.

>look
Hallway
You are in the hallway of the abandoned house.  Once it may have been a cherished home but now it is a ruin. The torn and faded wallpaper is covered in graffiti.  The evening sun filters through broken windows, illuminating dust motes hanging in the air.

A crumbling staircase leads up to the first floor

A heavy wooden door leads to to the cellar

You can also see a pile of junk mail here.

>get staircase
That's fixed in place.

>get door
That's fixed in place.

>showe
That's not a verb I recognise.

>showeme
That's not a verb I recognise.

>showme
Hallway - room
    yourself - person
        torch
    crumbling staircase - staircase
    cellar door - closed door
    pile of junk mail

>iv
That's not a verb I recognise.

>inv
You are carrying:
  a torch

* * *

>x junk
As you sift through the junk mail, a postcard catches your eye.

>look
Hallway
You are in the hallway of the abandoned house.  Once it may have been a cherished home but now it is a ruin.  The torn and faded wallpaper is covered in graffiti.  The evening sun filters through broken windows, illuminating dust motes hanging in the air.  A crumbling staircase leads up to the first floor.  A pile of junk mail is scattered on the ground.

A heavy wooden door in front of you leads to the cellar, it is closed.

>get junk
You browse through the junk mail but find nothing interesting, so decide to leave it.

>x junk
An assortment of advertisments and unpaid bills from years ago.

In the pile of junk mail is a postcard.

>get postcard
Taken.

* * *

>look
Hallway
You are in the hallway of the abandoned house.  Once it may have been a cherished home but now it is a ruin.  The torn and faded wallpaper is covered in graffiti.  The evening sun filters through broken windows, illuminating dust motes hanging in the air.  A crumbling staircase leads up to the first floor.  A pile of junk mail is scattered on the ground.

A heavy wooden door in front of you leads to the cellar, it is closed.

>inv
You are carrying:
  a torch

* * *

>x junk
As you sift through the junk mail, a postcard catches your eye.

>read postcastf
You can't see any such thing.

>read postcarsd
You can't see any such thing.

>read postcard
The front of the postcard is a photograph of a ruined building, perhaps a temple. In the middle of the ruin is a statue of a woman cradling a child. Although the picture is faded, you can almost make out a sad expression on the woman's face.  The back of the postcard is blank, except for a stamp with a postmark.

>examine stamp
You can't see any such thing.

>examine postmark
You can't see any such thing.

* * *

>x junk
As you sift through the junk mail, a postcard catches your eye.

>x door
A heavy wooden door, covered in flaking paint. From behind the door you can hear a faint humming sound.

>x sound
You can't see any such thing.

>up
You can't go that way.

* * *

>go up
You can't go that way.

>climb staircase
You can't see any such thing.

>d
Cellar Staircase
You are standing at the top of a wooden staircase, which descends into the gloomy cellar.  The air is musty and damp.  You can hear a low humming sound coming from below.

>d
You can't go that way.

* * *

>x junk
As you sift through the junk mail, a postcard catches your eye.

>x postcard
You see nothing special about the postcard.

>inv
You are carrying:
  a torch

>look
Hallway
You are in the hallway of the abandoned house.  Once it may have been a cherished home but now it is a ruin.  The torn and faded wallpaper is covered in graffiti.  The evening sun filters through broken windows, illuminating dust motes hanging in the air.  A crumbling staircase leads up to the first floor.  A pile of junk mail is scattered on the ground.

A heavy wooden door in front of you leads to the cellar, it is closed.

>get postcard
Taken.

>inv
You are carrying:
  a postcard
  a torch

>look
Hallway
You are in the hallway of the abandoned house.  Once it may have been a cherished home but now it is a ruin.  The torn and faded wallpaper is covered in graffiti.  The evening sun filters through broken windows, illuminating dust motes hanging in the air.  A crumbling staircase leads up to the first floor.  A pile of junk mail is scattered on the ground.

A heavy wooden door in front of you leads to the cellar, it is closed.

* * *

Cellar
An Interactive Fiction by Phil Gleghorn
Release 1 / Serial number 220423 / Inform 7 build 6M62 (I6/v6.34 lib 6/12N) SD

Hallway
You are in the hallway of the abandoned house.  Once it may have been a cherished home but now it is a ruin.  The torn and faded wallpaper is covered in graffiti.  The evening sun filters through broken windows, illuminating dust motes hanging in the air.  A crumbling staircase leads up to the first floor.  A pile of junk mail is scattered on the ground.

A heavy wooden door in front of you leads to the cellar, it is closed.

>x junk mail
An assortment of advertisments and unpaid bills from years ago

>get junk
You browse through the junk mail but find nothing interesting, so decide to leave it.

* * *

>open door
You open the cellar door.

>look
Hallway
You are in the hallway of the abandoned house.  Once it may have been a cherished home but now it is a ruin. The torn and faded wallpaper is covered in graffiti.  The evening sun filters through broken windows, illuminating dust motes hanging in the air.  A pile of junk mail covers the floor.

A crumbling staircase leads up to the first floor

A heavy wooden door leads to to the cellar, it is open.

>examine door
It is covered in flaking paint, with heavy hinges and a tarnished brass latch. You can see a gloomy passage beyond, and hear a strange humming noise from within

>enter
You must supply a noun.

>enter door
Dark Passage
You are standing at the top of a dark passage, which descends into the gloomy cellar.  The air is musty and damp.  You can hear a low humming sound coming from below. 

A heavy wooden door leads to back to the hallway, it is open.

>d
You can't go that way.

>down
You can't go that way.

>n
You can't go that way.

* * *

Cellar
An Interactive Fiction by Phil Gleghorn
Release 1 / Serial number 220423 / Inform 7 build 6M62 (I6/v6.34 lib 6/12N) SD

Hallway
You are in the hallway of the abandoned house.  Once it may have been a cherished home but now it is a ruin.  The torn and faded wallpaper is covered in graffiti.  The evening sun filters through broken windows, illuminating dust motes hanging in the air.  A crumbling staircase leads up to the first floor.  A pile of junk mail is scattered on the ground.

A heavy wooden door in front of you leads to the cellar, it is closed.

>x ladder
blah blah.

>get ladder
You can't see any such thing.

* * *

>x ladder
blah blah.

>get laddewr
You can't see any such thing.

>get ladder
That's hardly portable.

* * *

Cellar
An Interactive Fiction by Phil Gleghorn
Release 1 / Serial number 220423 / Inform 7 build 6M62 (I6/v6.34 lib 6/12N) SD

Hallway
You are in the hallway of the abandoned house.  Once it may have been a cherished home but now it is a ruin.  The torn and faded wallpaper is covered in graffiti.  The evening sun filters through broken windows, illuminating dust motes hanging in the air.  A crumbling staircase leads up to the first floor.  A pile of junk mail is scattered on the ground.

A heavy wooden door in front of you leads to the cellar, it is closed.

>x pil
You can't see any such thing.

>x pile
woot

* * *

Cellar
An Interactive Fiction by Phil Gleghorn
Release 1 / Serial number 220423 / Inform 7 build 6M62 (I6/v6.34 lib 6/12N) SD

Hallway
You are in the hallway of the abandoned house.  Once it may have been a cherished home but now it is a ruin.  The torn and faded wallpaper is covered in graffiti.  The evening sun filters through broken windows, illuminating dust motes hanging in the air.  A crumbling staircase leads up to the first floor.  A pile of junk mail is scattered on the ground.

A heavy wooden door in front of you leads to the cellar, it is closed.

>x pile
An uninteresting assortment of advertisments and unpaid bills

>x junk
An uninteresting assortment of advertisments and unpaid bills

>get junk
You browse through the junk mail but find nothing interesting, so decide to leave it.

>look
Hallway
You are in the hallway of the abandoned house.  Once it may have been a cherished home but now it is a ruin. The torn and faded wallpaper is covered in graffiti.  The evening sun filters through broken windows, illuminating dust motes hanging in the air.

A crumbling staircase leads up to the first floor

In front of you stands a heavy wooden cellar door

You can also see a pile of junk mail here.

>up
(first opening the staircase)
You can't, since the staircase leads nowhere.

* * *

Cellar
An Interactive Fiction by Phil Gleghorn
Release 1 / Serial number 220423 / Inform 7 build 6M62 (I6/v6.34 lib 6/12N) SD

Hallway
You are in the hallway of the abandoned house.  Once it may have been a cherished home but now it is a ruin.  The torn and faded wallpaper is covered in graffiti.  The evening sun filters through broken windows, illuminating dust motes hanging in the air.  A crumbling staircase leads up to the first floor.  A pile of junk mail is scattered on the ground.

A heavy wooden door in front of you leads to the cellar, it is closed.

>x staircase
It is falling apart and will surely collapse if you put any weight on it.

>climb staircase
Little is to be achieved by that.

* * *

>x staircase
It is falling apart and will surely collapse if you put any weight on it.

>get staircase
That's fixed in place.

>up
It doesn't look safe to use the staircase

* * *

>x staircase
It is falling apart and will surely collapse if you put any weight on it.

>up
It doesn't look safe to use the staircase

>x junk
An assortment of advertisments and unpaid bills from years ago

>get junk
You browse through the junk mail but find nothing interesting, so decide to leave it.

>x windows
Dirty and smashed

>get windows
You don't want to cut yourself

>n
(first opening the cellar door)

Dark Passage
You are standing at the top of a dark passage, which descends into the gloomy cellar.  The air is musty and damp.  You can hear a low humming sound coming from below. 

A heavy wooden door behind you leads back to the hallway, it is open.

>d
Darkness
It is pitch dark, and you can't see a thing.

* * *

Cellar
An Interactive Fiction by Phil Gleghorn
Release 1 / Serial number 220423 / Inform 7 build 6M62 (I6/v6.34 lib 6/12N) SD

Hallway
You are in the hallway of the abandoned house.  Once it may have been a cherished home but now it is a ruin.  The torn and faded wallpaper is covered in graffiti.  The evening sun filters through broken windows, illuminating dust motes hanging in the air.  A crumbling staircase leads up to the first floor.  A pile of junk mail is scattered on the ground.

A heavy wooden door in front of you leads to the cellar, it is closed.

>x torch
A small battery-operated torch.

The torch is currently switched off.

>turn torch on
You switch the torch on.

>x torch
A small battery-operated torch.

The torch is currently switched on.

>n
(first opening the cellar door)

Dark Passage
You are standing at the top of a dark passage, which descends into the gloomy cellar.  The air is musty and damp.  You can hear a low humming sound coming from below. 

A heavy wooden door leads to back to the hallway

>d
You can't go that way.

* * *

Cellar
An Interactive Fiction by Phil Gleghorn
Release 1 / Serial number 220423 / Inform 7 build 6M62 (I6/v6.34 lib 6/12N) SD

Hallway
You are in the hallway of the abandoned house.  Once it may have been a cherished home but now it is a ruin.  The torn and faded wallpaper is covered in graffiti.  The evening sun filters through broken windows, illuminating dust motes hanging in the air.  A crumbling staircase leads up to the first floor.  A pile of junk mail is scattered on the ground.

A heavy wooden door in front of you leads to the cellar, it is closed.

>x windows
Dirty and smashed.

>eat junk
That's plainly inedible.

>smell junk
You smell nothing unexpected.

>get windows
Taken.

>get graffiti
You can't see any such thing.

* * *

>x windows
Dirty and smashed.

>get windows
You don't want to cut yourself.

>x junk
An assortment of advertisments and unpaid bills from years ago

* * *

>x windows
Dirty and smashed.

>open windows
It isn't something you can open.

>x graffifi
You can't see any such thing.

>x graffiti
A mess of names and scribbles, painted on top of each other, accumulated over years.

>x junk
As you sift through the junk mail, a postcard catches your eye.

>get postcard
You already have that.

>x postcard
The front of the postcard is a photograph of what looks to be a ruined temple. In the centre is a statue of a woman holding a child. Although the postcard is faded, you can almost make out the sad expression on the woman's face.  The back of the postcard is blank, except for a stamp with a postmark.

>look
Hallway
You are in the hallway of the abandoned house.  Once it may have been a cherished home but now it is a ruin.  The torn and faded wallpaper is covered in graffiti.  The evening sun filters through broken windows, illuminating dust motes hanging in the air.  A crumbling staircase leads up to the first floor.  A pile of junk mail is scattered on the ground.

A heavy wooden door in front of you leads to the cellar, it is closed.

* * *

>inv
You are carrying:
  a postcard
  a torch

>x staircase
It is falling apart and will surely collapse if you put any weight on it.

>up
It doesn't look safe to use the staircase.

>open doppor
You can't see any such thing.

>open door
You open the cellar door.

* * *

>close door
You close the cellar door.

It is now pitch dark in here!

>s
(first opening the cellar door)

Hallway
You are in the hallway of the abandoned house.  Once it may have been a cherished home but now it is a ruin.  The torn and faded wallpaper is covered in graffiti.  The evening sun filters through broken windows, illuminating dust motes hanging in the air.  A crumbling staircase leads up to the first floor.  A pile of junk mail is scattered on the ground.

A heavy wooden door in front of you leads to the cellar, it is open.

* * *

>n
Dark Passage
You are standing at the top of a dark passage, which descends into the gloomy cellar.  The air is musty and damp.  You can hear a low humming sound coming from below. 

A heavy wooden door behind you leads back to the hallway, it is open.

>d
Darkness
It is pitch dark, and you can't see a thing.

>use tortch
That's not a verb I recognise.

>use torch
That's not a verb I recognise.

* * *

>x windows
Dirty and smashed.

>x broken windows
You see nothing special about Broken windows.